1111111111111111111111111
1P0001000C0M00000000C0001
1011101110111110111111101
10001000001000M0100000101
1110111111101111101110101
1000C0000010C000001000001
1111111110111111111011111
1000000010000000000010001
1011111110111111111110101
100C000000C00000000M00001
1111111111111011111111101
100M00000000001000C000001
1011111111111111111111101
10E0000000000000000000001
1111111111111111111111111