11111111111
1P00000E001
10000000001
10111111101
101C0000101
10111111101
11111111111
