11111111111
1P000000C01
10000000001
10111111101
101E0000101
10111111101
11111111111
