1111111111111
1P1C000000E01
101000000C001
101111111C101
10100000C0001
1111111111111
