11111111111111111111111111111111111111
1C0000000000000000000000000000000000E1
10000001110011100000011111111100000001
10000001110011100000011111111100000001
10000001110011100000000000011100000001
10000001111111100000000000011100000001
10000001111111100000011111111100000001
10000000000011100000011111111100000001
10000000000011100000011100000000000001
10000000000011100000011100000000000001
1000P000000011100000011111111100000001
10000000000011100000011111111100000001
1C0000000000000000000000000000000000C1
11111111111111111111111111111111111111