1111111111111
1CCCCCCCCCCC1
1CCCCCCCCCCC1
1PCCCCECCCCC1
1111111111111
