11111111111111111111111111111111111111111111111111111
1P000000000000000C00000000000000000000000000000000011
10111111101111110111111110111111101111111011111111E11
10100000001000000010000000100000001000000010000000101
10101111101011111010111110101111101011111010111110101
10100000001000000010000000100000001000000010000C00101
10111111101111111011111110111111101111111011111110101
10000000000000000000000000000000000000000000000000101
11111110111111111111111011111111111111101111111110101
10000000100000000000000010000000000000001000000000101
10111110101111111111111010111111111111101011111111101
10100000100C00000000000010000000000000C01000000000001
10101111111111111011111111111111101111111111111111101
10100C00000000000010000000000000001000000000000000101
10111111111111111011111111111111101111111111111111101
10000000000000000000000000000000000000000000000000C01
11111111111111111111111111111111111111111111111111111
