111111111111111
1P00000C0000001
100111111110001
1000C000C000001
111000E00001111
100000111000001
10C000000000C01
111111111111111
